11111111111111111111
10000000000000000001
10111001111110011101
10111001111110011101
10000000000000000001
10100111111111100101
10100000000000000101
10111100111100111101
10000000000000000001
11110011111111001111
11110011111111001111
10000000000000000001
10111100111100111101
10100000000000000101
10100111111111100101
10000000000000000001
10111001111110011101
10111001111110011101
10000000000000000001
11111111111111111111
