11111111111111111111
10000000000000000001
10111101111110111101
10111101111110111101
10000000000000000001
10101111111111110101
10100000000000000101
10111101111101111101
10000000000000000001
11110111111111101111
11110111111111101111
10000000000000000001
10111101111101111101
10100000000000000101
10101111111111110101
10000000000000000001
10111101111110111101
10111101111110111101
10000000000000000001
11111111111111111111
